1,4,0,40,0,0,255,255,255,255,255,255
5,8,0,40,0,0,255,255,255,255,255,255
9,12,0,40,0,0,255,255,255,255,255,255
13,16,0,40,0,0,255,255,255,255,255,255
17,20,0,40,0,0,255,255,255,255,255,255
