0,0,32,0,2,0,0,0
32,0,32,32,1,0,0,0
32,32,0,32,2,0,0,0
0,32,0,0,1,0,0,0
32,32,64,32,2,0,0,0
64,32,64,64,1,0,0,0
64,64,32,64,2,0,0,0
32,64,32,32,1,0,0,0